㐷	傌
㐽	偑
㑇	㑳
㑈	倲
㑔	㑯
㑩	儸
㓥	劏
㔉	劚
㖊	噚
㖞	喎
㗷	㘔
㘎	㘚
㚯	㜄
㛀	媰
㛟	𡞵
㛠	𡢃
㛣	㜏
㛤	孋
㛿	𡠹
㝍	写
㟆	㠏
㟜	𡾱
㟥	嵾
㡎	幓
㤘	㥰
㤽	懤
㥪	慺
㧏	掆
㧐	㩳
㧑	撝
㧛	掔
㧟	擓
㧠	擟
㧰	擽
㧱	拿
㨈	擠
㨫	㩜
㭎	棡
㭏	椲
㭣	𣙎
㭤	樢
㭴	樫
㰸	歛
㱩	殰
㱮	殨
㲿	瀇
㳔	濧
㳕	灡
㳠	澾
㳡	濄
㳢	𣾷
㴋	潚
㶉	鸂
㶶	燶
㶽	煱
㺍	獱
㻅	璯
㻏	𤫩
㻘	𤪺
䀥	䁻
䁖	瞜
䂵	碽
䃅	磾
䅉	稏
䅟	穇
䅪	𥢢
䇲	筴
䉤	籔
䌶	䊷
䌷	紬
䌸	縳
䌹	絅
䌺	䋙
䌻	䋚
䌼	綐
䌽	綵
䌾	䋻
䌿	䋹
䍀	繿
䍁	繸
䎬	䎱
䏝	膞
䓓	薵
䓕	薳
䓖	𧅓
䓨	罃
䗖	螮
䘞	𧜗
䙊	𧜵
䙌	䙡
䙓	襬
䛓	譼
䜣	訢
䜤	鿁
䜥	𧩙
䜧	䜀
䜨	漶
䜩	讌
䝙	貙
䝲	贐
䞌	𧵳
䞍	䝼
䞎	𧶧
䞐	賰
䢀	𨊰
䢁	𨊸
䢂	𨋢
䥺	釾
䥽	鏺
䥾	䥱
䥿	𨯅
䦀	𨦫
䦁	𨧜
䦂	䥇
䦃	鐯
䦅	鐥
䦆	钁
䦶	䦛
䦷	䦟
䩄	靦
䭪	𩞯
䯃	𩣑
䯄	騧
䯅	䯀
䲝	䱽
䲞	𩶘
䲟	鮣
䲠	鰆
䲡	鰌
䲢	鰧
䲣	䱷
䲤	鿐
䴓	鳾
䴔	鵁
䴕	鴷
䴖	鶄
䴗	鶪
䴘	鷉
䴙	鷿
䶮	龑
丑	醜
专	専
业	業
丛	叢
东	東
丝	糸
丢	丟
两	両
严	厳
並	併
丧	喪
个	箇
丬	爿
丰	豊
临	臨
为	為
丽	麗
举	挙
么	幺
义	義
乌	烏
乐	楽
乔	喬
乘	乗
习	習
乡	郷
书	書
买	買
亂	乱
于	於
亏	虧
云	雲
亘	亙
亙	亘
亚	亜
亞	亜
产	産
亩	畝
亲	親
亵	褻
亸	嚲
亿	億
仅	僅
仆	僕
从	従
仑	侖
仓	倉
仪	儀
们	們
价	価
仿	倣
众	衆
优	優
伛	傴
伞	傘
伟	偉
传	伝
伡	俥
伣	俔
伤	傷
伥	倀
伦	倫
伧	傖
伪	偽
伫	佇
佔	占
佛	仏
你	ｲ
佡	尓
佢	佡
佣	佢
佤	傭
佥	僉
佦	僉
佧	佦
佩	佨
佪	佩
佫	佪
佬	佫
佮	佭
佯	佮
佰	佯
佱	佰
佲	佱
佳	佲
佴	佳
佶	併
佷	佶
佸	佷
佹	佸
佺	佹
佻	佺
佼	佻
佽	佼
佾	佽
侀	使
侁	侀
侂	侁
侃	侂
侄	侃
侅	姪
來	侅
侇	来
侈	侇
侉	侈
例	侊
侌	例
侍	侌
侎	侍
侏	侎
侐	侏
侑	侐
侒	侑
侓	侒
侔	侓
侕	侔
侖	侕
侗	侖
侣	侶
侥	僥
侦	偵
侧	側
侨	僑
侩	儈
侪	儕
侬	儂
俁	俣
俇	仼
俞	兪
俠	侠
俦	儔
俨	儼
俩	倆
俪	儷
俫	倈
俭	倹
俯	俛
俱	倶
倂	併
個	箇
倜	俶
债	債
值	値
倾	傾
假	仮
偬	傯
偷	偸
偻	僂
偾	僨
偿	償
傤	儎
傥	儻
傧	儐
储	儲
傩	儺
傯	偬
傳	伝
僞	偽
僩	僴
價	価
儉	倹
儿	児
兑	兌
兒	児
兔	兎
兖	兗
內	内
兩	両
兰	蘭
关	関
兴	興
兹	茲
养	養
兽	獣
冁	囅
内	內
冈	岡
册	冊
军	軍
农	農
冢	塚
冯	馮
冰	氷
冱	冴
冲	沖
决	決
况	況
冻	凍
净	浄
凄	淒
准	準
凉	涼
减	減
凑	湊
凛	凜
几	幾
凤	鳳
凫	鳧
凭	憑
凯	凱
凶	兇
击	撃
凿	鑿
刍	芻
划	劃
刘	劉
则	則
刚	剛
创	創
删	刪
刨	鉋
别	別
刬	剗
刭	剄
刹	剎
刽	劊
刾	㓨
刿	劌
剀	剴
剂	剤
剎	刹
剐	剮
剑	剣
剝	剥
剥	剝
剧	劇
剩	剰
劄	箚
劍	剣
劑	剤
劝	勧
办	辦
务	務
劢	勱
动	動
劲	勁
劳	労
势	勢
勋	勲
勖	勗
勚	勩
勛	勲
勞	労
勳	勲
勵	励
勸	勧
勻	匀
匀	勻
匦	匭
匮	匱
區	区
华	華
协	協
单	単
卖	売
占	佔
卢	盧
卤	滷
卧	臥
卫	衛
却	卻
卷	巻
卻	却
卽	即
厂	廠
厅	庁
历	暦
厉	厲
压	圧
厌	厭
厍	厙
厐	龎
厕	厠
厘	釐
厢	廂
厣	厴
厦	廈
厩	廄
厪	𢋓
厮	廝
县	県
參	参
叆	靉
叇	靆
发	発
变	変
叙	敘
叠	畳
只	隻
叶	葉
叹	嘆
叽	嘰
吃	喫
吊	弔
后	後
吒	咤
吓	嚇
吕	呂
吗	嗎
吞	呑
吨	噸
听	聴
启	啓
吳	呉
吴	呉
呐	吶
呒	嘸
呓	囈
呕	嘔
呖	嚦
呗	唄
员	員
呙	咼
呛	嗆
呜	嗚
周	週
咏	詠
咒	呪
咔	哢
咙	嚨
咛	嚀
咝	噝
咤	吒
咸	鹹
响	響
哑	唖
哒	噠
哓	嘵
哔	嗶
哕	噦
哗	嘩
哙	噲
哜	嚌
哝	噥
哟	喲
唛	嘜
唝	嗊
唠	嘮
唡	啢
唢	嗩
唤	喚
唧	喞
啞	唖
啟	啓
啡	琲
啧	嘖
啬	嗇
啭	囀
啮	噛
啯	嘓
啰	囉
啴	嘽
啸	嘯
喂	餧
單	単
喷	噴
喻	喩
喽	嘍
喾	嚳
嗫	囁
嗳	噯
嘘	噓
嘤	嚶
噓	嘘
噜	嚕
嚏	嚔
嚙	噛
嚣	囂
嚴	厳
囊	嚢
囑	嘱
团	団
园	園
囱	囪
围	囲
图	図
圆	円
圈	圏
國	国
圍	囲
圓	円
圖	図
團	団
圣	聖
圹	壙
场	場
坏	壊
块	塊
坚	堅
坛	壇
坜	壢
坝	壩
坞	塢
坟	墳
坠	墜
垄	壟
垅	壠
垆	壚
垒	塁
垦	墾
垩	堊
垫	墊
垭	埡
垯	墶
垱	壋
垲	塏
垴	堖
埘	塒
埙	塤
埚	堝
堇	菫
堑	塹
堯	尭
塆	壪
墙	墻
增	増
墮	堕
壓	圧
壘	塁
壞	壊
壤	壌
壯	壮
壳	殻
壶	壷
壸	壼
壹	壱
壺	壷
壻	婿
壽	寿
处	処
备	備
复	復
够	夠
头	頭
夸	誇
夹	夾
夺	奪
奁	匳
奂	奐
奋	奮
奖	奨
奧	奥
奩	匳
奬	奨
奸	姦
妆	粧
妇	婦
妈	媽
妒	妬
妝	粧
妩	嫵
妪	嫗
妫	嬀
姊	姉
姗	姍
姜	薑
姬	姫
娄	婁
娅	婭
娆	嬈
娇	嬌
娈	孌
娘	嬢
娛	娯
娱	娯
娲	媧
娴	嫺
婳	嫿
婴	嬰
婵	嬋
婶	嬸
媪	媼
媭	嬃
嫒	嬡
嫔	嬪
嫱	嬙
嫻	嫺
嬷	嬤
孃	嬢
孙	孫
孪	孿
學	学
宁	寧
实	実
宠	寵
审	審
宪	憲
宫	宮
宽	寛
宾	賓
寇	冦
寑	寝
寢	寝
實	実
寫	写
寬	寛
寶	宝
对	対
寻	尋
导	導
將	将
專	専
對	対
尔	爾
尘	塵
尙	尚
尝	嘗
尧	尭
尴	尷
尸	屍
尽	儘
层	層
屃	屓
屆	届
屉	屜
屡	屢
屢	屡
屦	屨
屬	属
屭	屓
屿	嶼
岁	歳
岂	豈
岈	谺
岖	嶇
岗	崗
岘	峴
岚	嵐
岛	島
岭	嶺
岽	崬
岿	巋
峃	嶨
峄	嶧
峣	嶢
峤	嶠
峥	崢
峦	巒
峽	峡
崂	嶗
崃	崍
崄	嶮
崭	嶄
嵘	峵
嵚	嶔
嵝	嶁
嶸	峵
嶽	岳
巅	巓
巔	巓
巖	巌
巠	坙
巢	巣
巩	鞏
巯	巰
币	幣
帅	帥
师	師
帏	幃
帐	帳
帘	簾
帜	幟
带	帯
帧	幀
帮	幇
帱	幬
帶	帯
帻	幘
帼	幗
幂	冪
幫	幇
干	乾
并	併
幹	干
广	広
庄	荘
庆	慶
庐	廬
庑	廡
库	庫
应	応
庙	廟
庞	龐
废	廃
庼	廎
廁	厠
廄	厩
廈	厦
廚	厨
廝	厮
廢	廃
廣	広
廪	廩
廳	庁
开	開
异	異
弃	棄
弑	弒
弒	弑
张	張
弪	弳
弯	彎
弹	弾
强	強
彈	弾
彌	弥
彐	彑
归	帰
录	録
彟	彠
彥	彦
彦	彥
彨	彲
彻	徹
徑	径
徕	徠
從	従
御	禦
徵	徴
德	徳
忆	憶
忏	懺
忧	憂
忾	愾
怀	懐
态	態
怂	慫
怃	憮
怄	慪
怅	悵
怆	愴
怜	憐
总	総
怼	懟
怿	懌
恆	恒
恋	戀
恒	恆
恤	卹
恳	懇
恶	悪
恸	慟
恹	懨
恺	愷
恻	惻
恼	悩
恽	惲
恿	慂
悀	愑
悅	悦
悫	愨
悬	懸
悭	慳
悮	悞
悯	憫
惊	驚
惠	恵
惡	悪
惧	懼
惩	懲
惫	憊
惬	愜
惭	慙
惮	憚
惯	慣
惱	悩
愈	癒
愠	慍
愤	憤
愦	憒
愼	慎
愿	願
慑	慴
慘	惨
慚	慙
憐	怜
憑	凭
應	応
懑	懣
懒	嬾
懔	懍
懶	嬾
懷	懐
懼	惧
懾	慴
戀	恋
戋	戔
戏	戯
戗	戧
战	戦
戬	戩
戯	戱
戰	戦
戲	戯
戶	戸
户	戸
戾	戻
扑	撲
托	託
扠	扨
扣	釦
执	執
扩	拡
扪	捫
扫	掃
扬	揚
扰	擾
抚	撫
抛	拋
抟	摶
抠	摳
抡	掄
抢	搶
护	護
报	報
抬	擡
拂	払
拈	撚
拋	抛
拓	搨
拔	抜
拜	拝
拟	擬
拢	攏
拣	揀
拥	擁
拦	攔
拧	擰
拨	撥
择	択
拼	拚
拿	拏
挂	掛
挚	摯
挛	攣
挜	掗
挝	撾
挞	撻
挠	撓
挡	擋
挢	撟
挣	掙
挤	擠
挥	揮
挦	撏
挽	輓
挾	挟
捆	梱
捍	扞
捝	挩
捞	撈
损	損
捡	撿
换	換
捣	搗
捨	舎
据	拠
捻	撚
掳	擄
掴	摑
掷	擲
掸	撣
掺	摻
掼	摜
插	挿
揭	掲
揽	攬
揾	搵
揿	撳
搀	攙
搁	擱
搂	摟
搅	撹
搔	掻
搖	揺
搜	捜
携	攜
摄	摂
摅	攄
摆	擺
摇	揺
摈	擯
摊	攤
摑	掴
撄	攖
撑	撐
撵	攆
撷	擷
撸	擼
撺	攛
擇	択
擊	撃
擔	担
據	拠
擞	擻
擧	挙
擴	拡
攒	攅
攜	携
攝	摂
攢	攅
攪	撹
收	収
效	効
敌	敵
敍	叙
敎	教
敕	勅
敘	叙
敛	斂
敦	惇
敩	斆
數	数
斋	斎
斓	斕
斗	鬥
斩	斬
斷	断
无	無
旣	既
时	時
旷	曠
旸	暘
昂	昻
昆	崑
昙	曇
昺	昞
昽	曨
显	顕
晉	晋
晋	晉
晒	曬
晓	暁
晔	曄
晕	暈
晖	暉
晚	晩
晝	昼
暂	暫
暧	曖
暨	曁
暱	昵
曆	暦
曉	暁
曬	晒
會	会
术	術
朴	樸
朵	朶
机	機
杀	殺
杂	雑
权	権
杆	桿
杠	槓
来	來
杨	楊
杩	榪
杰	傑
松	鬆
极	極
构	構
枞	樅
枣	棗
枥	櫪
枧	梘
枨	棖
枪	槍
枫	楓
枭	梟
柏	栢
柜	櫃
柠	檸
查	査
柩	柾
柽	檉
栀	梔
栅	柵
标	標
栈	桟
栉	櫛
栊	槞
栋	棟
栌	櫨
栎	櫟
栏	欄
树	樹
栖	棲
样	様
栾	欒
桠	椏
桡	橈
桢	楨
档	檔
桤	榿
桥	橋
桦	樺
桧	檜
桨	槳
桩	樁
桪	樳
桴	枹
桿	杆
條	条
梦	夢
梼	檮
梾	棶
梿	槤
检	検
棁	梲
棂	櫺
棧	桟
棱	稜
椁	槨
椝	槼
椟	櫝
椠	槧
椢	槶
椤	欏
椫	樿
椭	楕
榄	欖
榅	榲
榆	楡
榇	櫬
榈	櫚
榉	欅
榨	搾
榮	栄
槇	槙
槔	槹
槚	檟
槛	檻
槟	梹
槠	櫧
槨	椁
槪	概
槶	椢
樂	楽
樓	楼
樞	枢
樣	様
樯	檣
樱	桜
機	机
橢	楕
橥	櫫
橫	横
橱	櫥
橹	櫓
橼	櫞
檐	簷
檔	档
檜	桧
檢	検
檩	檁
檮	梼
檳	梹
櫳	槞
櫸	欅
櫻	桜
權	権
欢	歓
欤	歟
欲	慾
歐	欧
歡	歓
步	歩
歲	歳
歷	暦
歸	帰
歼	殲
殁	歿
殇	殤
殒	殞
殓	殮
殘	残
殚	殫
殡	殯
殼	殻
毁	毀
毂	轂
毆	殴
每	毎
毕	畢
毗	毘
毙	斃
毡	氈
毵	毿
氇	氌
气	気
氛	雰
氢	氫
氣	気
氩	氬
氲	氳
汇	匯
汉	漢
污	汚
汤	湯
汹	洶
沈	瀋
沒	没
沟	溝
没	沒
沣	灃
沤	漚
沥	瀝
沦	淪
沧	滄
沨	渢
沩	潙
沪	滬
沵	濔
泄	洩
泛	氾
泞	濘
注	註
泪	涙
泶	澩
泷	滝
泸	瀘
泺	濼
泻	潟
泼	溌
泽	沢
泾	涇
洁	潔
洼	窪
浃	浹
浆	漿
浇	澆
浈	湞
浉	溮
浊	濁
测	測
浍	澮
济	済
浏	瀏
浐	滻
浑	渾
浒	滸
浓	濃
浔	潯
浕	濜
涂	塗
涉	渉
涌	湧
涛	濤
涝	澇
涞	淶
涟	漣
涠	潿
涡	渦
涢	溳
涣	渙
涤	滌
润	潤
涧	澗
涨	漲
涩	渋
涸	凅
淀	澱
淒	凄
淚	涙
淨	浄
淸	清
淺	浅
渊	淵
渍	漬
渎	涜
渐	漸
渑	澠
渔	漁
渖	瀋
渗	滲
渴	渇
游	遊
溁	濚
溃	潰
溅	濺
溇	漊
溉	漑
溪	渓
溫	温
溯	遡
滗	潷
滚	滾
滟	灧
滠	灄
满	満
滢	瀅
滤	濾
滥	濫
滦	灤
滨	浜
滩	灘
滪	澦
滯	滞
滿	満
潆	瀠
潇	瀟
潋	瀲
潍	濰
潑	溌
潛	潜
潴	瀦
澀	渋
澁	渋
澛	瀂
澜	瀾
澤	沢
濑	瀬
濒	瀕
濕	湿
濟	済
濤	涛
濱	浜
瀆	涜
瀉	潟
瀧	滝
瀨	瀬
灌	潅
灏	灝
灑	洒
灣	湾
灭	滅
灵	霊
灶	竃
灾	災
灿	燦
炀	煬
炖	燉
炜	煒
炝	熗
炫	衒
炮	砲
炼	錬
炽	熾
烁	爍
烂	燗
烃	烴
烛	燭
烟	煙
烦	煩
烧	焼
烨	燁
烩	燴
烫	燙
烬	燼
热	熱
焕	煥
焖	燜
焘	燾
焰	焔
煅	煆
煉	錬
燈	灯
燒	焼
營	営
爐	炉
爛	燗
爭	争
爱	愛
爲	為
爷	爺
牆	墻
牍	牘
牦	犛
牵	牽
牺	犠
犁	犂
犊	犢
犧	犠
犷	獷
犸	獁
犹	猶
狀	状
狈	狽
狝	獮
狞	獰
狮	獅
狯	獪
狰	猙
狱	獄
狲	猻
狹	狭
猃	獫
猎	猟
猕	獼
猡	玀
猪	豬
猫	貓
猬	蝟
獎	奨
獨	独
獭	獺
獵	猟
獸	獣
獻	献
玑	璣
玙	璵
玚	瑒
玛	瑪
玮	瑋
环	環
现	現
玱	瑲
玺	璽
珏	玨
珐	琺
珑	瓏
珰	璫
珲	琿
琅	瑯
琎	璡
琏	璉
琐	瑣
琼	瓊
瑤	瑶
瑯	琅
瑷	璦
瑸	璸
璎	瓔
瓒	瓚
瓮	甕
瓯	甌
甁	瓶
甕	瓮
產	産
电	電
畅	暢
畫	画
畬	畭
畲	畭
畴	疇
當	当
疆	彊
疊	畳
疏	疎
疖	癤
疗	療
疟	瘧
疠	癘
疡	瘍
疬	癧
疭	瘲
疮	瘡
疯	瘋
疴	痾
痈	癰
痉	痙
痒	癢
痖	瘂
痨	癆
痪	瘓
痫	癇
痱	疿
痹	痺
瘅	癉
瘆	瘮
瘗	瘞
瘘	瘻
瘦	痩
瘪	癟
瘫	癱
瘺	瘻
瘾	癮
瘿	癭
癞	癩
癡	痴
癢	痒
癣	癬
癫	癲
發	発
皂	梍
皋	皐
皑	皚
皰	疱
皱	皺
皲	皸
盏	盞
盐	塩
监	監
盖	蓋
盘	盤
盜	盗
盡	尽
盪	蕩
眍	瞘
眞	真
眦	眥
眬	矓
眯	瞇
眾	衆
着	著
睁	睜
睐	睞
睑	瞼
睪	睾
睿	叡
瞆	瞶
瞋	嗔
瞒	瞞
瞩	矚
矫	矯
矶	磯
矾	礬
矿	鉱
砀	碭
码	碼
砖	甎
砗	硨
砚	硯
砜	碸
砺	礪
砻	礱
砾	礫
础	礎
硁	硜
硏	研
硕	碩
硖	硤
硗	磽
硙	磑
硚	礄
确	確
硵	磠
硷	鹸
碍	礙
碎	砕
碗	椀
碛	磧
碜	磣
碱	鹼
磚	甎
磷	燐
礙	碍
礦	鉱
礪	砺
祃	禡
祇	祗
祎	禕
祕	秘
祢	禰
祯	禎
祷	禱
祸	禍
祿	禄
禀	稟
禄	祿
禪	禅
禮	礼
禱	祷
离	離
秃	禿
秆	稈
种	種
积	積
秽	穢
秾	穠
稅	税
稣	穌
稱	称
稳	穏
稻	稲
穎	頴
穑	穡
穗	穂
穞	穭
穩	穏
穰	穣
穷	窮
窍	竅
窎	窵
窑	窯
窗	窓
窜	竄
窝	窩
窥	窺
窦	竇
窭	窶
竊	窃
竖	竪
竝	並
竞	競
笃	篤
笋	筍
笑	咲
笔	筆
笕	筧
笮	筰
笺	牋
笼	篭
笾	籩
筑	築
筚	篳
筛	篩
筜	簹
筝	箏
筱	篠
筹	籌
筼	篔
签	簽
筿	篠
简	簡
箋	牋
箓	籙
箦	簀
箧	篋
箨	籜
箩	籮
箪	簞
箫	簫
箬	篛
篑	簣
篓	簍
篡	簒
篦	箆
篮	籃
篯	籛
篱	籬
簖	籪
簞	箪
簷	檐
籁	籟
籐	籘
籠	篭
籴	糴
类	類
粘	黏
粜	糶
粝	糲
粤	粵
粪	糞
粮	糧
粵	粤
粹	粋
紧	緊
紮	扎
絕	絶
絲	糸
絷	縶
經	経
綠	緑
綢	紬
緖	緒
緣	縁
縣	県
縱	縦
總	総
繈	繦
繡	繍
繩	縄
繪	絵
繼	継
纊	絋
續	続
纖	繊
纘	纉
纟	糸
纠	糾
纡	紆
红	紅
纣	紂
纤	繊
纥	紇
约	約
级	級
纨	紈
纩	絋
纪	紀
纫	紉
纬	緯
纭	紜
纮	紘
纯	純
纰	紕
纱	紗
纲	綱
纳	納
纴	紝
纵	縦
纶	綸
纷	紛
纸	紙
纹	紋
纺	紡
纼	紖
纽	紐
纾	紓
线	線
绀	紺
绁	紲
绂	紱
练	練
组	組
绅	紳
细	細
织	織
终	終
绉	縐
绊	絆
绋	紼
绌	絀
绍	紹
绎	繹
经	経
绐	紿
绑	綁
绒	絨
结	結
绔	絝
绕	繞
绖	絰
绗	絎
绘	絵
给	給
绚	絢
绛	絳
络	絡
绝	絶
绞	絞
统	統
绠	綆
绡	綃
绢	絹
绣	繍
绤	綌
绥	綏
绦	絛
继	継
绨	綈
绩	績
绪	緒
绫	綾
绬	緓
续	続
绮	綺
绯	緋
绰	綽
绱	緔
绲	緄
绳	縄
维	維
绵	綿
绶	綬
绷	繃
绸	紬
绹	綯
绺	綹
绻	綣
综	綜
绽	綻
绾	綰
绿	緑
缀	綴
缁	緇
缂	緙
缃	緗
缄	緘
缅	緬
缆	纜
缇	緹
缈	緲
缉	緝
缊	縕
缋	繢
缌	緦
缍	綞
缎	緞
缏	緶
缐	線
缑	緱
缒	縋
缓	緩
缔	締
缕	縷
编	編
缗	緡
缘	縁
缙	縉
缚	縛
缛	縟
缜	縝
缝	縫
缞	縗
缟	縞
缠	纏
缡	縭
缢	縊
缣	縑
缤	繽
缥	縹
缦	縵
缧	縲
缨	纓
缩	縮
缪	繆
缫	繅
缬	纈
缭	繚
缮	繕
缯	繒
缰	繮
缱	繾
缲	繰
缳	繯
缴	繳
缵	纉
缺	欠
缽	鉢
罂	罌
罐	缶
网	網
罗	羅
罚	罰
罢	罷
罴	羆
羁	羈
羇	覊
羟	羥
羡	羨
翘	翹
翙	翽
翚	翬
耀	燿
耢	耮
耧	耬
耸	聳
耻	恥
聂	聶
聋	聾
职	職
聍	聹
联	聯
聩	聵
聪	聡
聰	聡
聲	声
聽	聴
肃	粛
肅	粛
肖	蕭
肠	腸
肤	膚
肮	骯
肾	腎
肿	腫
胀	脹
胁	脅
胄	冑
胜	勝
胧	朧
胨	腖
胪	臚
胫	脛
胭	臙
胶	膠
脉	脈
脍	膾
脏	臓
脐	臍
脑	脳
脓	膿
脔	臠
脚	腳
脫	脱
脶	腡
脸	臉
腊	臘
腌	醃
腘	膕
腦	脳
腭	顎
腳	脚
腻	膩
腼	靦
腽	膃
腾	騰
膑	臏
膻	羶
膽	胆
臜	臢
臟	臓
臺	台
舆	輿
與	与
舉	挙
舊	旧
舍	舎
舖	舗
舣	艤
舰	艦
舱	艙
舻	艫
艰	艱
艳	艶
艷	艶
艹	艸
艺	芸
节	節
芈	羋
芗	薌
芜	蕪
芦	蘆
芸	蕓
苇	葦
苈	藶
苋	莧
苌	萇
苍	蒼
苎	苧
苏	蘇
苧	薴
苹	蘋
范	範
茏	蘢
茑	蔦
茔	塋
茕	煢
茧	繭
荆	荊
荐	薦
荔	茘
荙	薘
荚	莢
荛	蕘
荜	蓽
荝	萴
荞	蕎
荟	薈
荠	薺
荡	蕩
荣	栄
荤	葷
荥	滎
荦	犖
荧	熒
荨	蕁
荩	藎
荪	蓀
荫	蔭
荬	蕒
荭	葒
荮	葤
药	薬
莅	蒞
莊	荘
莓	苺
莖	茎
莱	萊
莲	蓮
莳	蒔
莴	萵
莶	薟
获	獲
莸	蕕
莹	瑩
莺	鴬
莼	蓴
萊	莱
萚	蘀
萝	蘿
萤	蛍
营	営
萦	縈
萧	蕭
萨	薩
萬	万
著	着
葱	蔥
蒇	蕆
蒉	蕢
蒋	蔣
蒌	蔞
蒞	莅
蓝	藍
蓟	薊
蓠	蘺
蓣	蕷
蓥	鎣
蓦	驀
蔣	蒋
蔥	葱
蔷	薔
蔹	蘞
蔺	藺
蔼	藹
蕰	薀
蕲	蘄
蕴	蘊
薮	藪
薰	薫
藏	蔵
藓	蘚
藝	芸
藥	薬
藪	薮
藴	蘊
蘆	芦
蘗	蘖
虏	虜
虑	慮
處	処
虛	虚
號	号
虬	虯
虱	蝨
虽	雖
虾	蝦
虿	蠆
蚀	蝕
蚁	蟻
蚂	螞
蚃	蠁
蚝	蠔
蚬	蜆
蛊	蠱
蛎	蠣
蛏	蟶
蛰	蟄
蛱	蛺
蛲	蟯
蛳	螄
蛴	蠐
蜕	蛻
蜗	蝸
蜡	蝋
蝇	蝿
蝈	蟈
蝉	蟬
蝼	螻
蝾	蠑
螀	螿
螢	蛍
螨	蟎
蟆	蟇
蟏	蠨
蟒	蠎
蟬	蝉
蟲	虫
蠅	蝿
蠍	蝎
蠟	蝋
蠢	惷
蠣	蛎
蠶	蚕
蠻	蛮
衅	釁
衔	啣
衞	衛
补	補
衬	襯
衮	袞
袄	襖
袅	嫋
袆	褘
袜	襪
袭	襲
袯	襏
裆	襠
裈	褌
裊	嫋
裝	装
裡	裏
裢	褳
裣	襝
裤	袴
裥	襇
褛	褸
褲	袴
褴	襤
襕	襴
覺	覚
覽	覧
觀	観
见	見
观	観
觃	覎
规	規
觅	覓
视	視
觇	覘
览	覧
觉	覚
觊	覬
觋	覡
觌	覿
觍	覥
觎	覦
觏	覯
觐	覲
觑	覷
觞	觴
觯	觶
觸	触
訚	誾
詟	讋
誊	謄
說	説
諫	諌
謠	謡
證	証
譯	訳
譽	誉
讀	読
變	変
讎	讐
讓	譲
讚	讃
讠	訁
计	計
订	訂
讣	訃
认	認
讥	譏
讦	訐
讧	訌
讨	討
让	譲
讪	訕
讫	訖
讬	託
训	訓
议	議
讯	訊
记	記
讱	訒
讲	講
讳	諱
讴	謳
讵	詎
讶	訝
讷	訥
许	許
讹	訛
论	論
讻	訩
讼	訟
讽	諷
设	設
访	訪
诀	訣
证	証
诂	詁
诃	訶
评	評
诅	詛
识	識
诇	詗
诈	詐
诉	訴
诊	診
诋	詆
诌	謅
词	詞
诎	詘
诏	詔
诐	詖
译	訳
诒	詒
诓	誆
诔	誄
试	試
诖	詿
诗	詩
诘	詰
诙	詼
诚	誠
诛	誅
诜	詵
话	話
诞	誕
诟	詬
诠	詮
诡	詭
询	詢
诣	詣
诤	諍
该	該
详	詳
诧	詫
诨	諢
诩	詡
诪	譸
诫	誡
诬	誣
语	語
诮	誚
误	誤
诰	誥
诱	誘
诲	誨
诳	誑
说	説
诵	誦
诶	誒
请	請
诸	諸
诹	諏
诺	諾
读	読
诼	諑
诽	誹
课	課
诿	諉
谀	諛
谁	誰
谂	諗
调	調
谄	諂
谅	諒
谆	諄
谇	誶
谈	談
谉	讅
谊	誼
谋	謀
谌	諶
谍	諜
谎	謊
谏	諌
谐	諧
谑	謔
谒	謁
谓	謂
谔	諤
谕	諭
谖	諼
谗	讒
谘	諮
谙	諳
谚	諺
谛	諦
谜	謎
谝	諞
谞	諝
谟	謨
谠	讜
谡	謖
谢	謝
谣	謡
谤	謗
谥	謚
谦	謙
谧	謐
谨	謹
谩	謾
谪	謫
谫	謭
谬	謬
谭	譚
谮	譖
谯	譙
谰	讕
谱	譜
谲	譎
谳	讞
谴	譴
谵	譫
谶	讖
谷	穀
豎	竪
豐	豊
豫	予
豬	猪
豮	豶
豺	犲
貉	狢
貒	猯
貓	猫
貘	獏
貳	弐
賣	売
賤	賎
賴	頼
贊	賛
贗	贋
贝	貝
贞	貞
负	負
贠	貟
贡	貢
财	財
责	責
贤	賢
败	敗
账	賬
货	貨
质	質
贩	販
贪	貪
贫	貧
贬	貶
购	購
贮	貯
贯	貫
贰	弐
贱	賎
贲	賁
贳	貰
贴	貼
贵	貴
贶	貺
贷	貸
贸	貿
费	費
贺	賀
贻	貽
贼	賊
贽	贄
贾	賈
贿	賄
赀	貲
赁	賃
赂	賂
赃	贓
资	資
赅	賅
赆	贐
赇	賕
赈	賑
赉	賚
赊	賒
赋	賦
赌	賭
赍	齎
赎	贖
赏	賞
赐	賜
赑	贔
赒	賙
赓	賡
赔	賠
赕	賧
赖	頼
赗	賵
赘	贅
赙	賻
赚	賺
赛	賽
赜	賾
赝	贋
赞	賛
赟	贇
赠	贈
赡	贍
赢	贏
赣	贛
赪	赬
赵	趙
赶	趕
趋	趨
趕	赶
趱	趲
趸	躉
跃	躍
跄	蹌
跞	躒
跶	躂
跷	蹺
跸	蹕
跹	躚
跻	躋
踊	踴
踌	躊
踐	践
踪	蹤
踬	躓
踯	躑
踴	踊
蹑	躡
蹒	蹣
蹠	跖
蹿	躥
躏	躙
躜	躦
躪	躙
躯	軀
躲	躱
軀	躯
輕	軽
轉	転
车	車
轧	軋
轨	軌
轩	軒
轪	軑
轫	軔
转	転
轭	軛
轮	輪
软	軟
轰	轟
轱	軲
轲	軻
轳	轤
轴	軸
轵	軹
轶	軼
轷	軤
轸	軫
轹	轢
轺	軺
轻	軽
轼	軾
载	載
轾	輊
轿	轎
辀	輈
辁	輇
辂	輅
较	較
辄	輒
辅	輔
辆	輛
辇	輦
辈	輩
辉	輝
辊	輥
辋	輞
辌	輬
辍	輟
辎	輜
辏	輳
辐	輻
辑	輯
辒	轀
输	輸
辔	轡
辕	轅
辖	轄
辗	輾
辘	轆
辙	轍
辚	轔
辟	闢
辨	弁
辩	弁
辫	辮
辭	辞
辯	弁
边	辺
辽	遼
达	達
迁	遷
过	過
迈	邁
运	運
还	還
这	這
进	進
远	遠
违	違
连	連
迟	遅
迩	邇
迳	逕
迹	跡
适	適
选	選
逊	遜
递	逓
逦	邐
逻	邏
逾	踰
遗	遺
遙	遥
遞	逓
遲	遅
邇	迩
邊	辺
邓	鄧
邝	鄺
邬	鄔
邮	郵
邹	鄒
邺	鄴
邻	隣
郁	鬱
郄	郤
郏	郟
郐	鄶
郑	鄭
郓	鄆
郞	郎
郦	酈
郧	鄖
郸	鄲
鄉	郷
鄕	郷
鄰	隣
酂	酇
酝	醞
酦	醗
酱	醤
酽	釅
酾	釃
酿	醸
醉	酔
醫	医
醬	醤
醱	醗
釀	醸
采	採
释	釈
釋	釈
里	裏
鉗	拑
鉞	戉
鉤	鈎
鉴	鑑
銜	啣
銮	鑾
銳	鋭
鋪	舗
錄	録
錢	銭
錾	鏨
鍊	錬
鎭	鎮
鏽	銹
鐮	鎌
鐵	鉄
鑄	鋳
鑛	鉱
鑪	鈩
钅	釒
钆	釓
钇	釔
针	針
钉	釘
钊	釗
钋	釙
钌	釕
钍	釷
钎	釺
钏	釧
钐	釤
钑	鈒
钒	釩
钓	釣
钔	鍆
钕	釹
钖	鍚
钗	釵
钘	鈃
钙	鈣
钚	鈈
钛	鈦
钜	鉅
钝	鈍
钞	鈔
钟	鐘
钠	鈉
钡	鋇
钢	鋼
钣	鈑
钤	鈐
钥	鑰
钦	欽
钧	鈞
钨	鎢
钩	鈎
钪	鈧
钫	鈁
钬	鈥
钭	鈄
钮	鈕
钯	鈀
钰	鈺
钱	銭
钲	鉦
钳	拑
钴	鈷
钵	鉢
钶	鈳
钷	鉕
钸	鈽
钹	鈸
钺	戉
钻	鑽
钼	鉬
钽	鉭
钾	鉀
钿	鈿
铀	鈾
铁	鉄
铂	鉑
铃	鈴
铄	鑠
铅	鉛
铆	鉚
铇	鉋
铈	鈰
铉	鉉
铊	鉈
铋	鉍
铌	鈮
铍	鈹
铎	鐸
铏	鉶
铐	銬
铑	銠
铒	鉺
铓	鋩
铔	錏
铕	銪
铖	鋮
铗	鋏
铘	鋣
铙	鐃
铚	銍
铛	鐺
铜	銅
铝	鋁
铞	銱
铟	銦
铠	鎧
铡	鍘
铢	銖
铣	銑
铤	鋌
铥	銩
铦	銛
铧	鏵
铨	銓
铩	鎩
铪	鉿
铫	銚
铬	鉻
铭	銘
铮	錚
铯	銫
铰	鉸
铱	銥
铲	剷
铳	銃
铴	鐋
铵	銨
银	銀
铷	銣
铸	鋳
铹	鐒
铺	舗
铻	鋙
铼	錸
铽	鋱
链	鏈
铿	鏗
销	銷
锁	鎖
锂	鋰
锃	鋥
锄	鋤
锅	鍋
锆	鋯
锇	鋨
锈	銹
锉	銼
锊	鋝
锋	鋒
锌	鋅
锍	鋶
锎	鐦
锏	鐧
锐	鋭
锑	銻
锒	鋃
锓	鋟
锔	鋦
锕	錒
锖	錆
锗	鍺
锘	鍩
错	錯
锚	錨
锛	錛
锜	錡
锝	鍀
锞	錁
锟	錕
锠	錩
锡	錫
锢	錮
锣	鑼
锤	錘
锥	錐
锦	錦
锧	鑕
锨	鍁
锩	錈
锪	鍃
锫	錇
锬	錟
锭	錠
键	鍵
锯	鋸
锰	錳
锱	錙
锲	鍥
锳	鍈
锴	鍇
锵	鏘
锶	鍶
锷	鍔
锸	鍤
锹	鍬
锺	鍾
锻	鍛
锼	鎪
锽	鍠
锾	鍰
锿	鎄
镀	鍍
镁	鎂
镂	鏤
镃	鎡
镄	鐨
镅	鎇
镆	鏌
镇	鎮
镈	鎛
镉	鎘
镊	鑷
镋	鎲
镌	鐫
镍	鎳
镎	鎿
镏	鎦
镐	鎬
镑	鎊
镒	鎰
镓	鎵
镔	鑌
镕	鎔
镖	鏢
镗	鏜
镘	鏝
镙	鏍
镚	鏰
镛	鏞
镜	鏡
镝	鏑
镞	鏃
镟	鏇
镠	鏐
镡	鐔
镢	钁
镣	鐐
镤	鏷
镥	鑥
镦	鐓
镧	鑭
镨	鐠
镩	鑹
镪	鏹
镫	鐙
镬	鑊
镭	鐳
镮	鐶
镯	鐲
镰	鎌
镱	鐿
镲	鑔
镳	鑣
镴	鑞
镵	鑱
镶	鑲
长	長
閒	閑
閱	閲
關	関
闢	辟
门	門
闩	閂
闪	閃
闫	閆
闬	閈
闭	閉
问	問
闯	闖
闰	閏
闱	闈
闲	閑
闳	閎
间	間
闵	閔
闶	閌
闷	悶
闸	閘
闹	閙
闺	閨
闻	聞
闼	闥
闽	閩
闾	閭
闿	闓
阀	閥
阁	閣
阂	閡
阃	閫
阄	鬮
阅	閲
阆	閬
阇	闍
阈	閾
阉	閹
阊	閶
阋	鬩
阌	閿
阍	閽
阎	閻
阏	閼
阐	闡
阑	闌
阒	闃
阓	闠
阔	闊
阕	闋
阖	闔
阗	闐
阘	闒
阙	闕
阚	闞
阛	闤
队	隊
阪	坂
阱	穽
阳	陽
阴	陰
阵	陣
阶	階
际	際
陆	陸
陇	隴
陈	陳
陉	陘
陕	陜
陝	陜
陦	隯
陨	隕
险	険
陷	陥
隐	隠
隨	随
險	険
隱	隠
隶	隷
隸	隷
隽	雋
难	難
雏	雛
雕	彫
雙	双
雜	雑
雞	鶏
雠	讐
雳	靂
雾	霧
霁	霽
霉	黴
霭	靄
霸	覇
靈	霊
靑	青
靓	靚
靔	靝
靜	静
靥	靨
靱	靭
鞑	韃
鞒	鞽
鞯	韉
韌	靭
韝	鞴
韦	韋
韧	靭
韨	韍
韩	韓
韪	韙
韫	韞
韬	韜
韭	韮
韵	韻
頩	頩
頰	頬
頸	頚
頹	頽
顏	顔
顯	顕
页	頁
顶	頂
顷	頃
顸	頇
项	項
顺	順
须	須
顼	頊
顽	頑
顾	顧
顿	頓
颀	頎
颁	頒
颂	頌
颃	頏
预	預
颅	顱
领	領
颇	頗
颈	頚
颉	頡
颊	頬
颋	頲
颌	頜
颍	潁
颎	熲
颏	頦
颐	頤
频	頻
颒	頮
颓	頽
颔	頷
颕	頴
颖	頴
颗	顆
题	題
颙	顒
颚	顎
颛	顓
颜	顔
额	額
颞	顳
颟	顢
颠	顛
颡	顙
颢	顥
颣	纇
颤	顫
颥	顬
颦	顰
颧	顴
风	風
飏	颺
飐	颭
飑	飆
飒	颯
飓	颶
飔	颸
飕	颼
飖	颻
飗	飀
飘	飄
飙	飆
飞	飛
飨	饗
餍	饜
餘	余
餚	肴
饋	餽
饥	飢
饨	飩
饩	餼
饪	飪
饫	飫
饬	飭
饭	飯
饮	飲
饯	餞
饰	飾
饱	飽
饲	飼
饴	飴
饵	餌
饶	饒
饷	餉
饸	餄
饺	餃
饼	餅
饽	餑
饾	餖
饿	餓
馀	余
馁	餒
馂	餕
馃	餜
馄	餛
馅	餡
馆	館
馇	餷
馈	餽
馉	餶
馊	餿
馋	饞
馌	饁
馍	饃
馎	餺
馏	餾
馐	饈
馑	饉
馒	饅
馓	饊
馔	饌
馕	饢
馱	駄
騭	隲
騷	騒
驅	駆
驒	騨
驗	験
驛	駅
马	馬
驭	馭
驮	駄
驯	馴
驰	馳
驱	駆
驲	馹
驳	駁
驴	驢
驵	駔
驶	駛
驷	駟
驸	駙
驹	駒
驺	騶
驻	駐
驼	駝
驽	駑
驾	駕
驿	駅
骀	駘
骁	驍
骂	罵
骃	駰
骄	驕
骅	驊
骆	駱
骇	駭
骈	駢
骉	驫
骊	驪
骋	騁
验	験
骍	騂
骎	駸
骏	駿
骐	騏
骑	騎
骒	騍
骓	騅
骔	騌
骕	驌
骖	驂
骗	騙
骘	騭
骙	騤
骚	騒
骛	騖
骜	驁
骝	騮
骞	騫
骟	騸
骠	驃
骡	騾
骢	𩣢
骣	驏
骤	驟
骥	驥
骦	驦
骧	驤
髅	髏
髋	髖
髌	髕
髒	臓
髓	髄
體	体
髥	髯
髮	髪
鬁	癧
鬓	鬢
鬧	閙
鬭	闘
鬶	鬹
魇	魘
魉	魎
鯰	鮎
鱉	鼈
鱷	鰐
鱼	魚
鱽	魛
鱾	魢
鱿	魷
鲀	魨
鲁	魯
鲂	魴
鲃	䰾
鲄	魺
鲅	鮁
鲆	鮃
鲇	鮎
鲈	鱸
鲉	鮋
鲊	鮓
鲋	鮒
鲌	鮊
鲍	鮑
鲎	鱟
鲏	鮍
鲐	鮐
鲑	鮭
鲒	鮚
鲓	鮳
鲔	鮪
鲕	鮞
鲖	鮦
鲗	鰂
鲘	鮜
鲙	鱠
鲚	鱭
鲛	鮫
鲜	鮮
鲝	鮺
鲞	鮝
鲟	鱘
鲠	鯁
鲡	鱺
鲢	鰱
鲣	鰹
鲤	鯉
鲥	鰣
鲦	鰷
鲧	鯀
鲨	鯊
鲩	鯇
鲪	鮶
鲫	鯽
鲬	鯒
鲭	鯖
鲮	鯪
鲯	鯕
鲰	鯫
鲱	鯡
鲲	鯤
鲳	鯧
鲴	鯝
鲵	鯢
鲶	鯰
鲷	鯛
鲸	鯨
鲹	鰺
鲺	鯴
鲻	鯔
鲼	鱝
鲽	鰈
鲾	鰏
鲿	鱨
鳀	鯷
鳁	鰛
鳂	鰃
鳃	鰓
鳄	鰐
鳅	鰍
鳆	鰒
鳇	鰉
鳈	鰁
鳉	鱂
鳊	鯿
鳋	鰠
鳌	鰲
鳍	鰭
鳎	鰨
鳏	鰥
鳐	鰩
鳑	鰟
鳒	鰜
鳓	鰳
鳔	鰾
鳕	鱈
鳖	鼈
鳗	鰻
鳘	鰵
鳙	鱅
鳚	䲁
鳛	鰼
鳜	鱖
鳝	鱔
鳞	鱗
鳟	鱒
鳠	鱯
鳡	鱤
鳢	鱧
鳣	鱣
鳤	䲘
鶯	鴬
鷄	鶏
鷏	鷆
鷗	鴎
鸟	鳥
鸠	鳩
鸡	鶏
鸢	鳶
鸣	鳴
鸤	鳲
鸥	鴎
鸦	鴉
鸧	鶬
鸨	鴇
鸩	鴆
鸪	鴣
鸫	鶇
鸬	鸕
鸭	鴨
鸮	鴞
鸯	鴦
鸰	鴒
鸱	鴟
鸲	鴝
鸳	鴛
鸴	鷽
鸵	鴕
鸶	鷥
鸷	鷙
鸸	鴯
鸹	鴰
鸺	鵂
鸻	鴴
鸼	鵃
鸽	鴿
鸾	鸞
鸿	鴻
鹀	鵐
鹁	鵓
鹂	鸝
鹃	鵑
鹄	鵠
鹅	鵝
鹆	鵒
鹇	鷴
鹈	鵜
鹉	鵡
鹊	鵲
鹋	鶓
鹌	鵪
鹍	鵾
鹎	鵯
鹏	鵬
鹐	鵮
鹑	鶉
鹒	鶊
鹓	鵷
鹔	鷫
鹕	鶘
鹖	鶡
鹗	鶚
鹘	鶻
鹙	鶖
鹚	鷀
鹛	鶥
鹜	鶩
鹝	鷊
鹞	鷂
鹟	鶲
鹠	鶹
鹡	鶺
鹢	鷁
鹣	鶼
鹤	鶴
鹥	鷖
鹦	鸚
鹧	鷓
鹨	鷚
鹩	鷯
鹪	鷦
鹫	鷲
鹬	鷸
鹭	鷺
鹮	䴉
鹯	鸇
鹰	鷹
鹱	鸌
鹲	鸏
鹳	鸛
鹴	鸘
鹵	滷
鹹	咸
鹼	鹸
鹽	塩
鹾	鹺
麥	麦
麸	麩
麹	麴
麽	麼
黃	黄
黉	黌
黑	黒
默	黙
點	点
黡	黶
黨	党
黩	黷
黪	黲
黾	黽
鼋	黿
鼌	鼂
鼍	鼉
鼗	鞀
鼹	鼴
齊	斉
齋	斎
齐	斉
齑	齏
齒	歯
齡	齢
齿	歯
龀	齔
龁	齕
龂	齗
龃	齟
龄	齢
龅	齙
龆	齠
龇	齜
龈	齦
龉	齬
龊	齪
龋	齲
龌	齷
龍	竜
龙	竜
龚	龔
龛	龕
龜	亀
龟	亀
龠	籥
鿏	䥑
鿒	鿓
鿔	鎶
洛	楽
烙	楽
珞	楽
落	楽
綠	緑
錄	録
壘	塁
樓	楼
淚	涙
讀	読
樂	楽
數	数
參	参
說	説
兩	両
勵	励
曆	暦
戀	恋
鍊	錬
說	説
獵	猟
靈	霊
禮	礼
惡	悪
樂	楽
龍	竜
狀	状
﨔	欅
况	況
搜	捜
