㐷	傌
万	萬
与	與
丑	醜	丑
专	專
业	業
丛	叢
东	東
丝	絲
丢	丟
两	兩
严	嚴
丧	喪
个	個	箇
丰	豐	丰
临	臨
为	為
丽	麗
举	舉
乃	乃	迺
么	麼	么
义	義	羛
乌	烏
乐	樂
乔	喬
习	習
乡	鄉
书	書
买	買
乱	亂
了	了	瞭
争	爭
于	於	于
亏	虧	亏
云	雲	云
亘	亙	亘
亚	亞
产	產
亩	畝
亲	親
亵	褻
亿	億
仅	僅
仆	僕
仇	仇	讎
从	從
仑	侖	崙
仓	倉
他	他	祂
仪	儀
们	們
价	價
仿	仿	彷
众	眾
优	優
伙	伙	夥
会	會
伞	傘
伟	偉
传	傳
伤	傷
伥	倀
伦	倫
伧	傖
伪	偽
伫	佇
佑	佑	祐
体	體
余	余	餘
佛	佛	彿
你	你	妳	祢
佣	佣	傭
佩	佩	珮
侄	侄	姪
侠	俠
侣	侶
侥	僥
侦	偵
侧	側
侨	僑
侩	儈
侬	儂
俦	儔
俨	儼
俩	倆
俪	儷
俭	儉
修	修
借	借	藉
债	債
倾	傾
偬	傯
偿	償
傧	儐
储	儲
傻	傻
僵	僵	殭
儿	兒
克	克	剋
兑	兌
兖	兗
党	黨
兰	蘭
关	關
兴	興
兹	茲
养	養
兽	獸	嘼
内	內
冈	岡
册	冊
写	寫
军	軍
农	農
冢	冢	塚
冬	冬	鼕
冯	馮
冲	衝	冲	沖
决	決
况	況
冻	凍
净	淨	净
凄	淒	悽
准	準	准
凉	涼
凌	凌	淩
减	減
凑	湊
凛	凜
几	幾
凤	鳳
凭	憑
凯	凱
凳	凳
凶	兇	凶
出	出	齣
击	擊
函	函
凿	鑿
刍	芻
划	劃	畫
刘	劉
则	則
刚	剛
创	創
删	刪
刨	刨	鉋	鑤
别	別	彆
刮	刮	颳
制	制	製
剀	剴
剂	劑
剃	剃	薙
剑	劍
剥	剝
剧	劇
剩	剩	賸
剿	剿	勦
劝	勸
办	辦
务	務
动	動
励	勵
劲	勁
劳	勞
势	勢
勋	勳	勛
勖	勖	勗
勤	勤	懃
匀	勻
匡	匡	劻
匮	匱
区	區
医	醫
匾	匾	楄
千	千	韆
升	升	昇
华	華	崋
协	協
单	單
卖	賣
卜	卜	蔔
占	佔	占
卢	盧
卤	滷	鹵
卧	臥
卫	衛
却	卻
卷	卷	捲
厂	廠
厅	廳
历	歷	曆	厤
厉	厲
压	壓
厌	厭
厕	廁
厘	釐	厘
厢	廂
厦	廈
厨	廚
厩	廄
厮	廝
县	縣
参	參	蔘
双	雙
发	發	髮
变	變
叙	敘	敍
叠	疊
只	隻	只
台	台	臺	檯	颱
叶	葉
号	號
叹	嘆
叽	嘰
吁	吁	籲
吃	吃	喫
合	合	閤
吊	吊	弔
同	同	衕
后	後
向	向	嚮	曏
吓	嚇
吕	呂
吗	嗎
吞	吞
吨	噸	吨	訰
听	聽
启	啟
吴	吳
呆	呆
呓	囈
呕	嘔
员	員
呛	嗆
呜	嗚
周	週	周
呼	呼	虖	謼
咏	詠	咏
咙	嚨
咛	嚀
咤	吒
咨	咨	諮
咯	咯	詻
咱	咱	偺
咸	咸	鹹
咸	鹹
咽	咽	嚥
哄	哄	鬨
响	響
哑	啞
哗	嘩	譁
哗	譁
哝	噥
哟	喲
唇	唇	脣
唉	唉	欸
唠	嘮
唤	喚
啕	啕	咷
啖	啖	啗
啧	嘖
啬	嗇
啭	囀
啮	齧
啰	囉
啸	嘯
喂	喂	餵
喧	喧
喷	噴
喽	嘍
嗫	囁
嗳	噯
嘘	噓
嘤	嚶
嘱	囑
嘻	嘻	譆
噜	嚕
噪	噪	譟
嚣	囂
回	回	迴
团	團	糰
园	園
困	困	睏
囱	囪
围	圍
国	國
图	圖
圆	圓
圣	聖
圬	圬
圭	圭	珪
圹	壙
场	場
坏	壞
坑	坑
块	塊
坚	堅
坛	壇	罈
坜	壢
坝	壩	垻
坞	塢	隖
坟	墳
坠	墜
坦	坦
垄	壟
垆	壚	罏
垒	壘
垦	墾
垩	堊
垫	墊
埙	塤
堑	塹
堕	墮
堤	堤	碮
墙	牆
壮	壯
声	聲
壳	殼
壶	壺
处	處
备	備
复	復	複	覆	复
多	多
够	夠
夫	夫	伕
夭	夭	殀
头	頭
夸	誇
夹	夾
夺	奪
奁	奩
奂	奐
奋	奮
奖	獎
奥	奧
奶	奶	嬭
奸	奸	姦
妆	妝
妇	婦
妈	媽
妩	嫵
妪	嫗
姗	姍
姜	薑	姜
娄	婁
娅	婭
娇	嬌
娘	娘	孃
娱	娛
娴	嫻
婴	嬰
婵	嬋
婶	嬸
媪	媼
嫔	嬪
嬷	嬤
孙	孫
学	學
孪	孿
宁	寧
它	它	牠
宝	寶
实	實
宠	寵
审	審
宪	憲
宫	宮
宴	宴	讌	醼
家	家	傢
宽	寬
宾	賓
寑	寢
寝	寢
对	對
寻	尋
导	導
寿	壽
将	將
尔	爾
尘	塵
尝	嘗	嚐
尧	堯
尴	尷
尸	屍
尽	儘	盡
局	局	侷	挶	跼
层	層
屉	屜
届	屆
属	屬
屡	屢
屿	嶼
岁	歲
岂	豈
岖	嶇
岗	崗
岚	嵐
岛	島
岩	岩
岭	嶺
岳	岳	嶽
峡	峽
峥	崢
峦	巒
峰	峰
崭	嶄
巅	巔
巨	巨	鉅
巩	鞏
币	幣
布	布	佈
帅	帥
师	師
帐	帳
帘	簾
帜	幟
带	帶
帧	幀
席	席	蓆
帮	幫
帼	幗
幡	幡	旛
幢	幢	橦
干	乾	干	幹	榦
并	並	并	併
幸	幸	倖
广	廣
庄	莊
庆	慶
床	床
庐	廬
库	庫
应	應
庙	廟
庞	龐
废	廢
庵	庵	菴
开	開
异	異
弃	棄
弄	弄	挵	衖
张	張
弥	彌	瀰
弦	弦	絃
弯	彎
弹	彈
强	強	彊
归	歸
当	當	噹
录	錄	彔
彗	彗	篲
彦	彥
彩	彩	綵
彻	徹
征	征	徵
径	徑	逕
御	禦	御
忆	憶
忏	懺
志	志	誌
忧	憂
念	念	唸
忾	愾
怀	懷
态	態
怂	慫
怅	悵
怆	愴
怜	憐
怪	怪
总	總
恋	戀
恒	恆
恤	卹	恤
恳	懇
恶	惡	噁
恸	慟
恹	懨
恻	惻
恼	惱
悖	悖	誖
悦	悅
悬	懸
悯	憫
惊	驚
惧	懼
惨	慘
惩	懲
惫	憊
惬	愜
惭	慚
惮	憚
惯	慣
愈	愈	癒
愠	慍
愤	憤
愧	愧	媿
愿	願
慑	懾
懑	懣
懒	懶
懔	懍
戏	戲
战	戰
戚	戚	慼
户	戶
才	才	纔
扎	扎	札	紮
扑	撲
托	託	托
扣	扣	釦
执	執
扩	擴
扪	捫
扫	掃
扬	揚	颺
扰	擾
折	折	摺
抚	撫
抛	拋
抠	摳
抡	掄
抢	搶
护	護
报	報
抬	抬
抵	抵	牴	觝
担	擔
拈	拈	撚
拐	拐	枴
拓	搨	拓
拟	擬
拢	攏
拣	揀
拥	擁
拦	攔
拧	擰
拨	撥
择	擇
拼	拚
挂	掛
挑	挑	䠷
挚	摯
挛	攣
挞	撻
挟	挾
挠	撓
挡	擋	攩
挣	掙
挤	擠
挥	揮
挨	挨	捱
挽	輓	挽
捂	捂	摀
捆	綑	捆	梱
捞	撈
损	損
捡	撿
换	換
捣	搗
据	據
捻	撚
掳	擄
掴	摑
掷	擲
揽	攬
搀	攙
搁	擱
搂	摟
搅	攪
搜	搜	蒐
携	攜
摄	攝
摆	擺	襬
摇	搖
摈	摒
摊	攤
撑	撐
撵	攆
擞	擻
攒	攢	儹	欑
效	效	傚
敌	敵
敕	敕
教	教
敛	斂	歛
数	數
斋	齋
斗	鬥	斗
斩	斬
断	斷
旋	旋	鏇
无	無
旧	舊
时	時
旷	曠
昆	崑	昆
昵	昵	暱
昼	晝
显	顯
晋	晉
晒	曬	晒
晓	曉
晕	暈
晖	暉
暂	暫
暗	暗	闇	晻
暧	曖
曲	曲	麴
札	札	劄
术	術	朮
朱	朱	硃
朴	樸
机	機
杀	殺
杂	雜
权	權
杆	桿
村	村	邨
杠	槓	杠
条	條
来	來
杨	楊
杯	杯	盃
杰	傑
松	鬆	松
板	板	闆
极	極
构	構
枞	樅
枢	樞
枣	棗
枪	槍	鎗
枫	楓
枭	梟
柜	櫃
柠	檸
栀	梔
栅	柵
标	標
栈	棧
栉	櫛
栋	棟
栏	欄
树	樹
栖	棲
栗	栗	慄
样	樣
核	核	覈
桢	楨
档	檔
桥	橋
桦	樺
桧	檜
桨	槳
桩	樁
梁	梁	樑
梦	夢
检	檢
棂	櫺
棰	棰	箠
棱	稜	棱
棹	棹	櫂
椁	槨
椟	櫝
椭	橢
楼	樓
榄	欖
榈	櫚
榨	榨	搾
槛	檻
槟	檳
横	橫
樯	檣
樱	櫻
橱	櫥
橹	櫓	艣
檐	簷	檐	譭
欢	歡	讙	驩
欤	歟
欧	歐
欲	慾	欲
歼	殲
殁	歿
殇	殤
残	殘
殓	殮
殡	殯
殴	毆
殷	殷	慇
毁	毀	燬
毂	轂
毕	畢
毙	斃
气	氣
氢	氫
氲	氳
汇	匯	彙
汉	漢
污	污
汤	湯
汹	洶
沄	沄	澐
沈	瀋	沈
沟	溝
没	沒
沥	瀝
沦	淪
沧	滄
沪	滬
沾	沾	霑
泄	泄	洩
泛	泛	氾	汎
泞	濘
注	註	注
泪	淚
泻	瀉
泼	潑
泽	澤
泾	涇
洁	潔
洒	灑	洒
洼	窪
浅	淺
浆	漿
浇	澆
浊	濁
测	測
济	濟
浏	瀏
浑	渾
浓	濃
浚	浚	濬
浩	浩	澔
涂	塗
涌	湧
涛	濤
涟	漣
涡	渦
涣	渙
涤	滌
润	潤
涧	澗
涨	漲
涩	澀
淀	澱
淆	淆
渊	淵
渍	漬
渎	瀆
渐	漸
渔	漁
渗	滲
温	溫
游	遊	游
湾	灣
湿	濕	溼
溃	潰
溅	濺
溪	谿	溪
溯	溯
滚	滾
滞	滯
满	滿
滤	濾
滥	濫
滦	灤
滨	濱
滩	灘
漓	漓	灕
演	演	縯
潇	瀟
潜	潛
澜	瀾
濑	瀨
濒	瀕
灭	滅
灯	燈
灵	靈
灶	灶
灾	災
灿	燦
炀	煬
炉	爐
炖	燉
炫	炫	衒
炮	炮	砲
点	點
炼	煉	鍊
炽	熾
烁	爍
烂	爛
烛	燭
烟	煙	菸
烦	煩
烧	燒
烨	燁
烩	燴
烫	燙
热	熱
焊	焊	銲
焕	煥
焖	燜
焰	焰	燄
熏	熏	燻
爱	愛
爷	爺
牍	牘
牦	犛
牵	牽
牺	犧
犊	犢
状	狀
犷	獷
犹	猶
狈	狽
狞	獰
独	獨
狭	狹
狮	獅
狰	猙
狱	獄
狸	狸	貍
猎	獵
猡	玀
猪	豬
猫	貓
献	獻
獭	獺
玑	璣
玛	瑪
玩	玩	翫
玮	瑋
环	環
现	現
玺	璽
珏	玨
珐	琺
珑	瓏
珲	琿
琅	瑯	琅
琐	瑣
琼	瓊
瑶	瑤
瑷	璦
璇	璇	璿
瓮	甕
瓯	甌
瓶	瓶	缾
电	電
画	畫
畅	暢
畴	疇
疗	療
疟	瘧
疠	癘
疡	瘍
疮	瘡
疯	瘋
疱	疱	皰
疴	痾
症	症	癥
痈	癰
痉	痙
痒	癢
痨	癆
痪	瘓
痴	痴
痹	痺
瘘	瘻
瘪	癟
瘫	癱
瘾	癮
癞	癩
癣	癬
癫	癲
皑	皚
皱	皺
盏	盞	醆
盐	鹽
监	監
盖	蓋
盗	盜
盘	盤
眬	矓
眯	瞇
着	著
睁	睜
睐	睞
睹	睹
睿	睿
瞒	瞞
瞩	矚
矫	矯
矶	磯
矾	礬
矿	礦
码	碼
砖	磚
砚	硯
砺	礪
砾	礫
础	礎
硕	碩
确	確
硷	鹼
碍	礙
碰	碰	踫
碱	鹼
磷	磷	燐
礼	禮
祯	禎
祷	禱
祸	禍
禀	稟
禄	祿
禅	禪
离	離
秃	禿	鵚
秆	稈
秋	秋	鞦
种	種
秘	秘	祕
积	積
称	稱
移	移	迻
秽	穢
税	稅
稣	穌
稳	穩
穑	穡
穗	穗	繐
穷	窮
窃	竊
窍	竅
窑	窯
窜	竄
窝	窩
窥	窺	闚
窦	竇
竖	豎
竞	競
笃	篤
笋	筍
笔	筆
笺	箋	牋
笼	籠
筑	築	筑
答	答	荅
筛	篩
筝	箏
筱	篠
筹	籌
签	簽	籤
简	簡
箧	篋
箩	籮
箪	簞
箫	簫
箬	篛
篑	簣
篓	簍
篮	籃
篱	籬
籁	籟
籴	籴	糴
类	類
粗	粗	麤
粘	黏
粤	粵
粪	糞
粮	糧
粽	粽
糊	糊	餬
糟	糟	蹧
系	系	係	繫
紧	緊
累	累	纍
纠	糾
红	紅
纣	紂
纤	纖	縴
纥	紇
约	約
级	級
纪	紀
纫	紉
纬	緯
纭	紜
纯	純
纰	紕
纱	紗
纲	綱
纳	納
纴	紝
纵	縱
纶	綸
纷	紛
纸	紙
纹	紋
纺	紡
纽	紐
线	線
绁	紲
练	練
组	組
绅	紳
细	細
织	織
终	終
绊	絆
绋	紼
绌	絀
绍	紹
绎	繹
经	經
绑	綁
绒	絨
结	結
绕	繞	遶
绘	繪
给	給
绚	絢
络	絡
绝	絕
绞	絞
统	統
绢	絹
绣	繡
绥	綏
绦	絛	縚
继	繼
绩	績
绪	緒
绫	綾
续	續
绮	綺
绰	綽
绳	繩
维	維
绵	綿
绷	繃
绸	綢
综	綜
绽	綻
绾	綰
绿	綠
缀	綴
缁	緇
缄	緘
缅	緬
缆	纜
缉	緝
缍	綞
缎	緞
缓	緩
缔	締
缕	縷
编	編
缘	緣
缚	縛
缝	縫
缠	纏
缢	縊
缣	縑
缤	繽
缧	縲
缨	纓
缩	縮
缪	繆
缫	繅
缭	繚
缮	繕
缰	繮	韁
缴	繳
罐	罐
网	網
罗	羅	囉
罚	罰
罢	罷
羁	羈
羡	羨
群	群
翘	翹
耸	聳
耻	恥
聂	聶
聋	聾
职	職
联	聯
聪	聰
肃	肅
肖	蕭	肖
肠	腸
肤	膚
肮	骯
肴	肴	餚
肾	腎
肿	腫
胀	脹
胁	脅
胆	膽
背	背	揹
胜	勝
胡	胡	鬍	衚
胧	朧
胪	臚
胫	脛
胭	胭
胶	膠
脉	脈
脍	膾
脏	髒	臟
脐	臍
脑	腦
脓	膿
脚	腳
脱	脫
脸	臉
腊	臘
腌	醃
腻	膩
腼	靦
腾	騰
膑	臏
膻	羶
臀	臀
致	致	緻
舆	輿
舍	捨	舍
舰	艦	䚀
舱	艙
艰	艱
艳	豔
艺	藝
节	節
芜	蕪
芦	蘆
芸	蕓	芸
苇	葦
苍	蒼
苎	苧
苏	甦	蘇	囌
苹	蘋
范	範
茎	莖
茧	繭
荆	荊
荐	薦
荚	莢
荡	蕩	盪
荣	榮
荤	葷
荦	犖
荪	蓀
荫	蔭	廕
药	藥	葯
莅	蒞
莱	萊
莲	蓮
莴	萵
获	獲	穫
莹	瑩
莺	鶯
莼	蒓	蓴
萝	蘿
萤	螢
营	營
萦	縈
萧	蕭
萨	薩
葱	蔥
蒋	蔣
蒙	蒙	懞	濛	矇
蓑	蓑	簑
蓝	藍
蓦	驀
蔑	蔑	衊
蔷	薔
蔺	藺
蔼	藹
蕴	蘊
薮	藪
藓	蘚
藤	藤	籐
虏	虜
虑	慮
虚	虛
虫	蟲
虬	虯
虮	虮	蟣
虱	蝨	虱
虽	雖
虾	蝦
蚀	蝕
蚁	蟻
蚂	螞
蚕	蠶
蚝	蠔
蛊	蠱
蛎	蠣
蛮	蠻
蛲	蟯
蜕	蛻
蜗	蝸
蜡	蠟	蜡
蝇	蠅
蝈	蟈
蝉	蟬
蝎	蝎	蠍
蝼	螻
衅	釁
衔	銜	啣
补	補
表	表	錶
衬	襯
衮	袞
袄	襖
袅	裊	嬝
袜	襪
袭	襲
装	裝
裆	襠
裤	褲
褛	褸
褴	襤
见	見
观	觀
规	規
觅	覓
视	視
览	覽
觉	覺
觊	覬
觎	覦
觐	覲
觞	觴
触	觸
誉	譽
誊	謄
计	計
订	訂
讣	訃
认	認
讥	譏
讦	訐
讧	訌
讨	討
让	讓
讪	訕
讫	訖
训	訓
议	議
讯	訊
记	記
讲	講
讳	諱
讶	訝
讷	訥
许	許
讹	訛
论	論
讼	訟
讽	諷
设	設
访	訪
诀	訣
证	證	証
诂	詁
评	評
诅	詛
识	識
诈	詐
诉	訴
诊	診
诋	詆
词	詞
诏	詔
译	譯
试	試
诗	詩
诘	詰
诙	詼
诚	誠
诛	誅
话	話
诞	誕
诟	詬
诠	詮
诡	詭
询	詢
诣	詣
诤	諍
该	該
详	詳
诧	詫
诫	誡
诬	誣
语	語
误	誤
诰	誥
诱	誘
诲	誨
诳	誑
说	說
诵	誦
请	請
诸	諸
诺	諾
读	讀
课	課
诿	諉
谁	誰
调	調
谄	諂
谅	諒
谆	諄
谈	談
谊	誼
谋	謀
谍	諜
谎	謊
谏	諫
谐	諧
谑	謔
谒	謁
谓	謂
谕	諭
谗	讒
谘	諮
谚	諺
谛	諦
谜	謎
谟	謨
谢	謝
谣	謠
谤	謗
谥	謚	諡
谦	謙
谨	謹
谬	謬
谭	譚
谱	譜
谲	譎
谴	譴
谶	讖
谷	穀	谷
象	象	像
贝	貝
贞	貞
负	負
贡	貢
财	財
责	責
贤	賢
败	敗
账	賬	帳
货	貨
质	質
贩	販
贪	貪
贫	貧
贬	貶
购	購
贮	貯
贯	貫
贰	貳
贱	賤
贲	賁
贴	貼
贵	貴
贷	貸
贸	貿
费	費
贺	賀
贻	貽
贼	賊
贾	賈
贿	賄
赀	貲
赁	賃
赂	賂
赃	贓
资	資
赅	賅
赈	賑
赊	賒
赋	賦
赌	賭
赎	贖
赏	賞
赐	賜
赔	賠
赖	賴
赘	贅
赚	賺
赛	賽
赝	贗
赞	讚	贊
赠	贈
赡	贍
赢	贏
赣	贛
赵	趙
赶	趕
趋	趨
趟	趟	蹚
趸	躉
跃	躍
跖	跖
践	踐
跶	躂
跷	蹺
踊	踴	踊
踌	躊
踪	蹤
踯	躑
蹑	躡
蹒	蹣
躏	躪
躯	軀
车	車
轧	軋
轨	軌
轩	軒
轫	軔
转	轉
轭	軛
轮	輪
软	軟
轰	轟
轲	軻
轴	軸
轶	軼
轻	輕
轼	軾
载	載
轾	輊
轿	轎
较	較
辄	輒
辅	輔
辆	輛
辇	輦
辈	輩
辉	輝
辍	輟
辎	輜
辐	輻
辑	輯
输	輸
辔	轡
辕	轅
辖	轄
辗	輾
辘	轆
辙	轍
辚	轔
辞	辭
辟	闢
辩	辯
辫	辮
边	邊
辽	遼
达	達
迁	遷	迁
过	過
迈	邁
运	運
还	還
这	這
进	進
远	遠
违	違
连	連
迟	遲
迤	迤	迆
迩	邇
迳	逕
迹	跡	蹟
适	適
选	選
逊	遜
递	遞
逦	邐
逻	邏
逾	逾
道	道	導
遗	遺
遥	遙
邓	鄧
邮	郵
邹	鄒
邻	鄰
郁	鬱	郁
郑	鄭
酝	醞
酬	酬	詶
酱	醬
酸	酸	痠
酿	釀
采	采	埰	寀	採
释	釋
里	裡	里	裏
鉴	鑒	鑑
銮	鑾
针	針	鍼
钉	釘
钊	釗
钏	釧
钓	釣
钗	釵
钙	鈣
钝	鈍
钞	鈔
钟	鐘	鍾
钠	鈉
钢	鋼
钤	鈐
钥	鑰	鈅
钦	欽
钧	鈞
钨	鎢
钩	鉤
钮	鈕
钱	錢
钳	鉗
钴	鈷
钵	缽
钸	鈽
钹	鈸
钻	鑽	鉆
钾	鉀
铀	鈾
铁	鐵
铂	鉑
铃	鈴
铄	鑠
铅	鉛
铉	鉉
铎	鐸
铐	銬
铙	鐃
铛	鐺
铜	銅
铝	鋁
铢	銖
铣	銑	鐉
铨	銓
铬	鉻
铭	銘
铮	錚
铰	鉸
铲	剷	剗	鏟
银	銀
铸	鑄
铺	鋪	舖
链	鏈
铿	鏗
销	銷
锁	鎖
锄	鋤	耡	鉏
锅	鍋
锈	鏽
锉	銼	剉
锋	鋒
锌	鋅
锐	銳
锑	銻
错	錯
锚	錨
锡	錫
锣	鑼
锤	錘
锥	錐
锦	錦
锭	錠
键	鍵
锯	鋸
锰	錳
锲	鍥
锵	鏘
锹	鍬
锻	鍛
锾	鍰
镀	鍍
镁	鎂
镂	鏤
镇	鎮
镍	鎳
镑	鎊
镕	鎔
镖	鏢
镗	鏜
镘	鏝
镙	鏍
镜	鏡
镝	鏑
镞	鏃
镣	鐐
镭	鐳
镯	鐲
镰	鐮
镳	鑣
镶	鑲
长	長
门	門
闩	閂
闪	閃
闭	閉
问	問
闯	闖
闰	閏
闱	闈
闲	閒	閑
间	間
闵	閔
闷	悶
闸	閘
闹	鬧
闺	閨
闻	聞
闽	閩
闾	閭
阀	閥
阁	閣
阂	閡
阅	閱
阎	閻
阐	闡
阑	闌
阔	闊
阕	闋
阖	闔
阗	闐
队	隊
阳	陽
阴	陰
阵	陣
阶	階
际	際
陆	陸
陇	隴
陈	陳
陕	陝	陜
陨	隕
险	險
随	隨
隐	隱
隶	隸
隽	雋
难	難
雁	雁
雇	僱
雇	雇
雏	雛
雕	雕	鵰	彫	琱
雳	靂
雾	霧
霁	霽
霉	霉	黴
霭	靄
靓	靚
静	靜
面	面	麵
靥	靨
鞑	韃
韦	韋
韧	韌
韩	韓
韬	韜
韵	韻
页	頁
顶	頂
顷	頃
项	項
顺	順
须	須	鬚
顼	頊
顽	頑
顾	顧	頋
顿	頓
颁	頒
颂	頌
预	預
颅	顱
领	領
颇	頗
颈	頸
颉	頡
颊	頰
颐	頤
频	頻
颓	頹
颔	頷
颖	穎
颗	顆
题	題
颚	顎
颛	顓
颜	顏
额	額
颞	顳
颠	顛
颤	顫
颦	顰
风	風
飏	颺
飒	颯
飓	颶
飕	颼
飘	飄
飙	飆
飞	飛
餍	饜
饥	飢	饑
饨	飩
饪	飪
饬	飭
饭	飯
饮	飲
饯	餞
饰	飾
饱	飽
饲	飼
饴	飴
饵	餌
饶	饒
饷	餉
饺	餃
饼	餅
饿	餓
馁	餒
馄	餛
馅	餡
馆	館
馈	餽
馈	饋	餽
馊	餿
馋	饞
馏	餾
馒	饅
马	馬
驭	馭
驮	馱
驯	馴
驰	馳
驱	驅
驳	駁	駮
驴	驢
驶	駛
驷	駟
驸	駙
驹	駒
驻	駐
驼	駝
驽	駑
驾	駕
驿	驛
骂	罵
骄	驕
骆	駱
骇	駭
骈	駢
骊	驪
骋	騁
验	驗
骏	駿
骑	騎
骗	騙
骚	騷
骛	騖
骞	騫
骠	驃
骡	騾
骤	驟
骥	驥
髅	髏
鬓	鬢
魇	魘
鱼	魚
鱿	魷
鲁	魯
鲈	鱸
鲍	鮑
鲔	鮪
鲛	鮫
鲜	鮮
鲢	鰱
鲤	鯉
鲧	鯀	鮌
鲨	鯊
鲫	鯽
鲳	鯧
鲸	鯨
鳀	鯷	鮷
鳃	鰓
鳄	鱷
鳅	鰍	鰌
鳌	鰲	鼇
鳍	鰭
鳏	鰥
鳔	鰾
鳖	鱉
鳖	鼈
鳗	鰻
鳜	鱖
鳝	鱔
鳞	鱗
鸟	鳥
鸠	鳩
鸡	雞
鸢	鳶
鸣	鳴
鸥	鷗
鸦	鴉
鸩	鴆	酖
鸪	鴣
鸭	鴨
鸯	鴦
鸰	鴒
鸳	鴛
鸵	鴕
鸶	鷥
鸽	鴿
鸾	鸞
鸿	鴻
鹃	鵑
鹄	鵠
鹅	鵝
鹇	鷴
鹉	鵡
鹊	鵲
鹌	鵪
鹏	鵬
鹑	鶉
鹚	鷀
鹞	鷂
鹤	鶴
鹦	鸚
鹧	鷓
鹭	鷺
鹰	鷹
麦	麥
麸	麩
麹	麴
麻	麻	痲	蔴
麽	麼
黄	黃
黩	黷
鼗	鞀	鞉	鼗
鼹	鼴
齐	齊
齿	齒
龃	齟
龄	齡
龇	齜
龈	齦
龉	齬
龊	齪
龋	齲
龌	齷
龙	龍
龚	龔
龟	龜
